P........
.........
.........
.........
.........
....p....
...#.....
.........
..r.....R
