.........
.........
.........
....p...P
R...#....
.........
......r..
.........
.........
